{
  "Cols": 14,
  "Rows": 14,
  "Buttons": [2, 6, 10, 14, 18, 22, 26, 30, 34, 38, 42, 46, 50, 54],
  "UnitSize": 1,

  "Maps": 
  [  
    [
      [4,4,1,1,1,1,1,1,1,1,1,4,4,4], 
      [4,1,1,1,1,1,1,1,1,1,1,4,4,4], 
      [1,1,2,2,2,2,2,2,2,1,1,2,2,2], 
      [1,1,1,3,3,2,3,3,2,1,1,1,3,3], 
      [1,1,1,1,3,2,3,1,2,1,1,1,1,3], 
      [2,2,2,1,1,2,9,1,2,2,2,2,1,1], 
      [9,1,1,1,1,2,1,1,1,3,3,2,1,1], 
      [1,1,1,1,1,2,1,1,1,1,3,2,1,1], 
      [1,1,2,2,2,2,2,2,2,1,1,2,1,1], 
      [1,1,2,3,1,3,1,3,2,1,1,2,1,1], 
      [1,1,2,1,3,1,3,1,2,1,1,2,1,1], 
      [1,1,2,1,1,2,1,1,2,1,1,2,1,1], 
      [4,1,1,1,1,2,4,4,2,1,1,1,1,1], 
      [4,4,1,1,1,2,4,4,2,1,1,1,1,1]
    ],
    [
      [1,1,1,1,3,1,3,1,1,1,1,1,3,3], 
      [1,1,1,1,1,3,1,1,1,1,1,1,1,3], 
      [1,1,2,2,2,2,2,2,2,2,2,2,1,1], 
      [4,4,2,9,1,1,1,1,2,9,1,1,1,1], 
      [4,4,2,1,1,1,1,1,2,1,1,1,1,1], 
      [2,2,2,1,1,2,1,1,2,1,1,2,2,2], 
      [3,3,1,1,1,2,1,1,1,1,1,1,3,3], 
      [3,1,1,1,1,2,1,1,1,1,1,1,1,3], 
      [1,1,2,1,1,2,2,2,2,2,2,2,1,1], 
      [1,1,2,1,1,1,1,1,2,4,4,2,1,1], 
      [1,1,2,1,1,1,1,1,2,4,4,2,1,1], 
      [1,1,2,1,1,1,1,1,2,1,1,2,1,1], 
      [4,4,2,4,4,4,4,4,2,1,1,1,1,1], 
      [4,4,2,4,4,4,4,4,2,1,1,1,1,1]
    ],  
    [
      [4,4,4,1,1,2,4,4,4,4,4,2,4,4], 
      [4,4,4,1,1,2,1,1,1,1,1,2,4,4], 
      [2,2,2,1,1,2,3,1,2,1,1,2,1,1], 
      [3,3,1,1,1,2,1,3,2,1,1,2,1,1], 
      [3,1,1,1,1,2,3,1,2,1,1,2,1,1], 
      [1,1,2,2,2,2,1,3,2,1,1,2,1,1], 
      [1,1,1,1,1,1,1,1,2,1,1,2,1,1], 
      [1,1,1,1,1,1,1,1,2,1,1,2,1,1], 
      [1,1,2,2,2,2,2,2,2,1,1,2,1,1], 
      [1,1,1,1,1,1,3,3,2,1,1,2,1,1], 
      [1,1,1,1,1,1,1,3,2,1,1,2,9,1], 
      [1,1,2,2,2,2,1,1,2,1,1,2,1,1], 
      [1,1,4,4,4,2,9,1,2,3,1,3,1,3], 
      [1,1,4,4,4,2,1,1,2,1,3,1,3,1]
    ],    
    [
      [1,1,1,1,3,1,1,1,1,3,3,2,4,4], 
      [1,1,1,3,1,3,1,1,1,1,3,2,4,4], 
      [1,1,2,2,2,2,1,1,2,1,1,2,4,4], 
      [1,1,4,4,4,2,1,1,2,9,1,2,1,1], 
      [1,1,4,4,4,2,1,1,2,1,1,2,1,1], 
      [2,2,2,2,2,2,1,1,2,1,1,2,1,1], 
      [3,3,1,9,1,2,1,1,2,1,1,1,1,1], 
      [3,1,1,1,1,2,1,1,2,1,1,1,1,1], 
      [1,1,2,1,1,2,1,1,2,2,2,2,3,1], 
      [1,1,2,1,1,1,1,3,2,4,4,2,1,3], 
      [1,1,2,1,1,1,3,3,2,4,4,2,3,1], 
      [1,1,2,2,2,2,2,2,2,4,4,2,1,3], 
      [1,1,1,1,4,4,4,4,2,1,1,1,1,1], 
      [1,1,1,1,4,4,4,4,2,1,1,1,1,1]
    ],
    [
      [4,4,4,1,1,2,9,1,1,1,1,1,3,3], 
      [4,4,4,1,1,2,1,1,1,1,1,1,1,3], 
      [2,2,2,1,1,2,1,1,2,2,2,2,1,1], 
      [1,1,1,1,1,2,1,1,2,3,3,1,1,1], 
      [1,1,1,1,1,2,1,1,2,3,1,1,1,1], 
      [1,1,2,2,2,2,1,1,2,1,1,2,2,2], 
      [3,1,2,3,3,1,1,1,2,1,1,1,3,3], 
      [1,3,2,3,1,1,1,1,2,1,1,1,1,3], 
      [3,1,2,1,1,2,1,1,2,2,2,2,1,1], 
      [1,3,2,1,1,2,4,4,4,4,4,2,1,1], 
      [3,1,2,1,1,2,4,4,4,4,4,2,1,1], 
      [1,3,2,1,1,2,2,2,2,2,2,2,1,1], 
      [9,1,1,1,1,2,4,4,4,4,4,4,1,1], 
      [1,1,1,1,1,2,4,4,4,4,4,4,1,1]  
    ],
    [
      [4,4,2,1,1,3,1,3,1,1,1,2,4,4], 
      [4,4,2,1,1,1,3,1,3,1,1,2,4,4], 
      [4,4,2,1,1,2,2,2,2,1,1,2,4,4], 
      [1,1,1,1,1,2,9,1,1,1,1,2,1,1], 
      [1,1,1,1,1,2,1,1,1,1,1,2,1,1], 
      [2,2,2,1,1,2,1,1,2,2,2,2,1,1], 
      [3,3,1,1,1,2,1,1,1,3,3,2,1,1], 
      [3,3,1,1,1,2,1,1,1,1,3,2,1,3], 
      [2,2,2,2,2,2,1,1,2,1,1,2,1,3], 
      [1,1,1,1,1,1,1,3,2,9,1,1,1,3], 
      [1,1,1,1,1,1,3,3,2,1,1,1,1,1], 
      [1,1,2,2,2,2,2,2,2,2,2,2,1,1], 
      [1,1,1,1,1,4,4,4,2,4,4,4,1,1], 
      [1,1,1,1,1,4,4,4,2,4,4,4,1,1]
    ]  
  ]
}